XXXXXXXXXXXXXXXXXXX
XM................X
X.XX.XXX.X.XXX.XX.X
X.................X
X.XX.X.XXXXX.X.XX.X
X....X...X...X....X
XXXX.XXX.X.XXX.XXXX
XX...X.......X...XX
XX.X.X.XXXXX.X.X.XX
XX.X...XmmmX...X.XX
XX.X.X.XXXXX.X.X.XX
XX...X.......X...XX
XXXX.X.XXXXX.X.XXXX
X........X........X
X.XX.XXX.X.XXX.XX.X
X..X...........X..X
XX.X.X.XXXXX.X.X.XX
X....X...X...X....X
X.XXXXXX.X.XXXXXX.X
X................CX
XXXXXXXXXXXXXXXXXXX
